
{
    "spriteSheet": "level1Tiles",
    "tiles": [
        "empty||",
        "solid|block.1|"
    ],
    "encode": [[
        "01000000000000000001000101",
        "00000000000000000000000000",
        "00000000000000000000000000",
        "00000000000000000000000000",
        "00000000000000000000000000",
        "00000000000000000000000000",
        "00000000000000000000000000",
        "00000000000000000000000000",
        "00000000000000000000000000",
        "00000000000000000000000000",
        "00000000000000000000000000",
        "00000000000000000000000000",
        "00000000000000000000000000",
        "00000000000000001010000000",
        "00000000000000000000000000",
        "00000000000101000000000000",
        "01010101010101010101010101",
        "00000000000000000000000000",
        "00000000000000000000000000",
        "00000000000000000000000000",
        "00000000000000000000000000",
        "00000000000000000000000000",
        "00000000000000000000000000",
        "00000000000000000000000000",
        "01000000000000000000000001"
    ]
]
    
}