
{
    "spriteSheet": "level1Tiles",
    "tiles": [
        "empty||",
        "solid|block.1|"
    ],
    "encode": [
        "01000000000000000001000101000000000000000000000000000000000000000000000000000000000000000000000000000000",
        "00",
        "00",
        "00",
        "00",
        "00",
        "00",
        "00",
        "00",
        "00000000000000000000000001000000000000000000000000000000000000000000000000000000000000000000000000000000",
        "00000000000000000000000001000000000000000000000000000000000000000000000000000000000000000000000000000000",
        "00000000000000000000000001000000000000000000000000000000000000000000000000000000000000000000000000000000",
        "01010000000000000000000001000000000000000000000000000000000000000000000000000000000000000000000000000000",
        "01000000000000000101000001000000000000000000000000000000000000000000000000000000000000000000000000000000",
        "01000000000101000000000001000000000000000000000000000000000000000000000000000000000000000000000000000000",
        "01000000000101000000000001000000000000000000000000000000000000000000000000000000000000000000000000000000",
        "01010101010101010101010100010101010101010101010101000101010101010101010101010001010101010101010101010101",
        "00000000000000000000000000000000000000000000000000000000000000000000000000000000000000000000000000000000",
        "00000000000000000000000000000000000000000000000000000000000000000000000000000000000000000000000000000000",
        "01000000000000000000000000000000000000000000000000000000000000000000000000000000000000000000000000000000",
        "01010000000101010101010101000000000000000000000000000000000000000000000000000000000000000000000000000000",
        "00",
        "00",
        "00",
        "000000000000000000000001010000000000000000"
    ]
    
}